111111111111111111111111111111
100000000000000000000000000001
101111111111111110111111111101
100000000311111110111111111101
101111111011111110111111111101
101111111011111110000000000001
101111111011111110111111111101
100000000000000000111111111101
101111011111011110111111111101
101111011111011113111111111101
101111311111011111111111111101
101111011111011111110000000031
101111000000000000000111101111
101111011111011111110111101111
101111011111411111110111101111
101111311111011111113111101111
101111111111011111111111101111
100000000000000000000000001111
111111011111111101111111101111
111111011111111101111111101111
100000011111111101113000001111
101111011111111101111111101111
101111011111111101111111101111
101111000000000000000000000031
101111111011111101111111101111
101111111011111101111111101111
101111111311111131111111101111
101111111111111101111111101111
120000000000000000000000001111
111111111111111111111111111111