1111111111111111111111111111111111111111111111
1300000000000000000000200000000000000000000031
1011111111101111111111111111111111111011111101
1011111111100000000000030000000000000000000001
1011111111101111111111111111111101111111111101
1011111111101111111111111111111101111111111101
1011111111101111111111111111111101111111111101
1011111111120000000000000000030000000011111101
1011111111101111111111111111111111111011111101
1011111111131111111111111111111111111000000001
1011111111101111111000000000011111111011111101
1011111111101111111011111111011111111011111101
1000030000001111111411111111000000000011111101
1011111111111111111011111111011111111111111101
1011111111111111111000000000011111111000000001
1011111111111111111111111111111111111011111101
1011111111111111111111111111111111111011111101
1200000000000000000000300000000000000000000031
1111111111111111111111111111111111111111111111